######################
#    #               #
#                    #
#                    #
#              #     #
##_#                 #
#  #                 #
######################