#####################
#                   #
#       #####       #
#       #   #       #
#       #   _       #
#       #   #       #
#       #   #       #
#       #####       #
#                   #
#####################