##########################################
#                                        #
#                                        #
#                                        #
#                ###D######              #
#                                        #
#                                        #
#                                        #
#                                        #
#               #######                  #
#                                        #
#                                        #
#                                        #
#                                        #
#                                        #
#                                        #
##########################################