#####################
# #     #       #   #
# # # # # # ### ### #
#   # # # # # #     #
# ### ### ### ##### #
# # #   # #   #   # #
# # ### # # ##### # #
# #   # #   #     # #
# # # # ##### # ### #
#   # #       #     #
#####################