##########################################
#                                        #
#                                        #
#                                        #
#                ###_######              #
#                                        #
#                                        #
#                                        #
#                                        #
#               #######                  #
#                                        #
#                                        #
#                                        #
#                                        #
#                                        #
#                                        #
##########################################