###############################################################
#         #             #       #     #     #             #   #
# ######### ######### ### # ### # # ### # # ##### ##### # # # #
# #       #   #     # #   # # # # # #   # #     # #     # # # #
# # ##### ### # ##### # ### # # # ### ### ##### ### ##### ### #
# #   # #     #     # # # # # # #       #   # #   # #     #   #
# ### # ########### # # # # # # ### ####### # ### # # ##### # #
#     #     #       # #   # #     # #   #   #   #   # #     # #
# ####### # # ####### ### # ##### ### # # ### # ##### ### ### #
#   #     #   #         # #     #     #   #   #     #   #   # #
### # ### ##### ####### # ##### ############### # ##### ### # #
#   # # # #     #     # # #   #               # #           # #
# ### # # # ##### ### # # ### ############### #################
# #   #   #     #   #   #         #         #       #         #
# # ### ####### ##### ########### ### ##### ####### # ####### #
# # #   #     # #   # #   #     #   #     #       #   #       #
# # ##### ### # # # ### # # # # ### ##### # ########### ##### #
# #     # # #   # #   # #   # #   #       # #         # #     #
# ##### # # ### # ### # ##### ### ######### # ####### # # #####
#     # # #     #   # # #   #   # #     #   # #         #   # #
##### # # ####### ### # ### ### # ##### # ### ############# # #
#       #         #   #   # #   #       # # #         #   #   #
# ############### # # ### # # ##### ##### # ######### # # ### #
#     #         # # #   #   # #   # #   # #         # # #     #
##### # ####### # # ### ### # ### # # # # # ##### ### # #######
#     #   #     # #   #   # #   #   # # # # #     #   #     # #
# ####### # ##### ### ##### ### ##### # # ### ##### ####### # #
# #     # #   # # # #     #   #       # #     #     #   # #   #
# # ### # ### # # # ##### ### ##### ### # ##### ##### # # ### #
#   # # #   # #         #     #   #   #   #     #     # #   # #
##### # ### # ############### # # ### ##### ######### # # ### #
# #       # # #     #   #   # # # # #     #     #   # #   #   #
# # ####### # # ### # # ### # # # # ##### ##### # # # ### # ###
#   #       # #   #   #   # # # # #           #   # # #   # # #
# ### ####### ### ##### ### ### # ########### ##### # ##### # #
# #   #     #   # #     #   #   #         #   # #   #       # #
### ####### ### # # ### # ### ########### # ### # ### ####### #
#   #         #   #   # # #   # #       # # #   #   # #       #
# ### ####### ####### ### ### # # ##### # # # # ### # # ##### #
# #   #     # #     #     #   #   #     # # # # #   # # # #   #
# ### # ### # # # ######### ### ### # ### # ### # ### # # # ###
# #   #   #   # #   #       #     # # #   #   # # #   #   #   #
# # ##### ##### ### # # ########### ### ##### # # # ######### #
# # #     #     #   # # #         # #   #       # # #         #
# # # ##### ##### # # # ### ##### # # ########### # # ####### #
#   #   # # #   # # # # #   #   #   # #           # #   #     #
####### # # ### # ### # # ### # ### # # ########### # # # #####
#       #   #   #     # #   # #     # #   #     #   # # #   # #
# ####### ### # ####### # # ######### ### # # ### ### # ### # #
#     #   #   # #     # # #           #   # # #   # # #   #   #
##### # ### ### # ### # ##### ######### ### # # ### # ### ### #
#   # #     # #   #   #     #   #       #   # # # #   # # #   #
# ### ####### ##### ####### ### # ####### # ### # # ### # #####
#   # #       #           # #   #   #     #   # # #   # # #   #
# # # ##### # # ########### # ##### ######### # # ### # # # # #
# # #     # # #   #   #   # #     #   #       # # #     #   # #
# # ##### # ### ### # # # # ##### ### # ##### # # # ####### # #
# #       #     #   #   # #     #     #   # # # #   # #   # # #
# ########### ### ####### ##### ######### # # # # ### # # ### #
#   #   #   #   # #   #   #   # #   #     #   # #     # #     #
### # # # # ##### # ### ### # # # ### # ####### ####### ##### #
#     #   #       #         #   #     #                 #     #
###############################################################